111111111
1P0000001
101C101C1
1C0101C01
1000000E1
111111111