11111111111111111
1P000000000000001
10111111111111011
10000000000001001
11101111111101001
1C0010000000100E1
11111111111111111