1111111111111
1000100000001
1000100000001
1000100C00001
1000100000001
1P00100A00001
1000100000001
1000100000001
100000000A001
1000100000001
1000100000E01
1111111111111